mkdir => 创建目录/文件夹
cd (change directory) => 改变目录
pretty => 漂亮
reflog => 刷新日志
track => 跟踪/轨迹
prefer => 偏爱
stupid => 蠢/笨
discard => 丢弃
access => 访问
figure => 数字/图像
muted => 静音
poster => 海报
subtitle => 字幕
chunk => 块
served => 服务/提供
favicon => 网站图标
option => 选项
shift => 转移
iterable => 可迭代的
rest => 其余/休息
notation => 符号/表示法
bundle => 包/束
merge => 合并
parse => 解析
stringify => 串化
browerify => 浏览器
engine => 引擎/发动机
strict => 严格
execution => 执行
client => 客户
oauth => 认证
token => 令牌
session => 会议
conflict => 冲突
upgrade => 升级
Switching Protocols => 交换协议